# define boundary list of points  x1,y1,x2,y2  . . . .
wall boundary
	50,700,250,700,430,540,270,350,180,300,180,180,250,100,450,300,
	600,300,700,200,700,100,800,100,800,290,900,300,900,400,680,400,
	460,350,510,590,660,650,750,700,950,700,1000,700,1000,550,750,570,
	600,530,610,470,760,490,1000,460,1000,240,890,220,890,0,650,0,
	570,150,520,190,460,190,250,10,100,150,100,350,250,500,250,550,
	50,550,50,700

# define landinding platform
wall end
	900,690,950,690

# pod initial position
pod
        60,600,100
