wall left
	350,550,450,550,540,580,610,570,670,550,740,470,740,420,730,380,
	690,350,660,300,670,240,710,190,700,120,640,90,560,100,520,130,
	480,180,480,230,530,290,600,330,660,410,670,470,640,510,580,530,
	510,510,430,470,370,390,340,300,340,200,310,150,260,120,190,130,
	140,180,130,240,160,300,250,350,280,390,270,480,260,520,270,550,
	310,560,340,550,350,550

wall right
	340,600,440,600,530,640,630,620,700,590,790,490,790,420,780,350,
	730,320,710,280,730,240,770,190,750,110,680,50,570,20,470,70,
	420,160,440,240,500,320,570,360,610,420,620,460,610,470,580,480,
	530,470,460,430,410,370,380,290,380,200,340,130,270,90,180,90,
	100,160,90,250,130,320,210,390,220,410,220,470,200,530,220,580,
	290,600,330,600,340,600


pod
    760,490,90

